#EA ./textures/Guillaume_other.xpm
#WE ./textures/Guillaume_other.xpm
#SO ./textures/Guillaume_other.xpm
#NO ./textures/Guillaume_other.xpm

#EA ./textures/42logo.xpm
#WE ./textures/42logo.xpm
#SO ./textures/42logo.xpm
#NO ./textures/42logo.xpm

F 255,255,255
C 255,255,255

111111111111111111
100000000000000001
100000000000000001
100000110011111001
100001100010011001
100011000000110001
100110000001100001
100111111011001001
100111111011111001
100000011000000001
100000011000000001
100000000000N00001
100000000000000001
111111111111111111
