F 0,155,0
C 0,0,155

NO textures/bluestone.xpm
SO textures/redbrick.xpm
WE textures/mossy.xpm
EA textures/wood.xpm


11111111111111111111111111111
10000000001100000000000000001
10110000011100000000000010001
10010000000000000000000010001
10110000011100000000000010001
10000000001100000111011110001
11110111111111011100000010001
11110111111111011100000010001
11000000110101011101010010101
10000000000000001100000010001
10000000000000011101010010001
11000000110101000000000000001
11110111110101000000000100001
100000000011000000N0000010011
10000100000000001000000101001
10000000001000010001010001001
10000000001101000000100000001
10000000000100000001010000001
11111111111111111111111111111