NO textures/bluestone.xpm
SO textures/redbrick.xpm
WE textures/purplestone.xpm
EA textures/wood.xpm

F 128,128,128
C 0,255,255

11111111111111111111111111111
10000000001100000000000000001
10110000011101111110000010001
10010000000000000000000010001
11110000000000000000000000111
10000000000000000000011110011
1111000000000E000000100010001
11110100000000000000010010001
11000000111111011100000010001
100000001    1111100011000001
10000000111111001101010010001
11000000110101011111011110001
11110111111101011111011110001
11111111111111111111111111111